##$ wil = 30; rec_val = 0.82
### start ---

### 한국사
모내기법; 이앙법: 조선 후기에 전국적으로 보급되어 쌀 생산량이 크게 늘게 한 것; 조선 후기에 전국적으로 보급되어 벼, 보리의 이모작이 가능하게 한 것.
모내기법; 이앙법: 조선 후기에 보급되어 잡초를 제거하는 일손이 줄게한 것.; 모판에 모를 미리 길러서 논에 옮겨 심는 방법.
부농: 모내기법으로 인해 필요 노동력이 줄자 경작지를 늘리고 인삼, 담배, 목화 등의 상품 작물을 재배하여 성장한 것.
공인: 대동법 실시 이후 왕실과 관청에 필요한 물품을 사서 납부하던 어용상인
송상-경강상인; 경강상인-송상: 조선 후기에 활동한 대상인 (2개)
민영 수공업; 민영수공업: 관영 수공업이 쇠퇴하고자 발달한 수공업; 이 형태의 수공업이 발달하자 장인들이 자유롭게 물건을 만들어 팔 수 있게 되었다.
광업: 수공업이 발달하자 광물의 수요가 증가하자 발달한 것.
공명첩: 정부가 재정을 보충하기 위해 돈이나 곡식 등을 받고 발행한 이름이 적히지 않은 관직 임명장; 이 것을 통해 부를 축적한 자가 합법적으로 양반 신분을 획득했다.
노비: 납속이나 군공또는 도망을 통해 이 신분이 신분 상승을 하였다.

실학: 17, 18세기에 나타난 여러 가지 폐해로 성리학의 한계가 인식되자 실용적이고 실증적인 방법으로 학문이 연구되어 등장한 것; 조선 후기 현실 사회를 개혁하기 위한 개혁 사상이고 다양한 분야를 연구하는 것.
중농학파: 일부 지주에게 토지가 집중되고 농민의 토지 이탈하는 현상으로 인해 등장한 실학의 한 분야.; 농촌 문제 해결에 주목하여 토지 제도의 개혁을 주장한 실학의 한 분야.
유형원: 균전론을 주장한 실학자.
이익: 한전론을 주장한 실학자.
정약용: 여전론을 주장한 실학자.; "경세유표", "목민심서", "흠흠신서" 등의 많은 저서를 집필한 실학자.
균전론; 균전: 농민에게 일정한 토지를 주자는 토지 개혁론; 유형원이 주장한 토지 개혁론
한전론; 한전: 생계를 유지하는데 필요한 최소한의 토지의 매매를 금하는 토지 개혁론; 이익이 주장한 토지 개혁론
여전론; 여전: 토지를 공동으로 경작하고 일한 날짜에 따라 분배하자는 토지 개혁론; 정약용이 주장한 토지 개혁론

중상학파; 북학파: 상공업의 발달과 도시의 변화로 인해 등장한 실학의 한 분야.; 상공업 진흥과 기술 혁신을 통한 개혁 방안을 주장한 실학의 한 분야.; 중국을 왕래하면서 직접 보고 들은 청의 선진 문물을 적극 수용할 것을 주장한 사람들.
유수원: 직업의 평등을 주장한 실학자.
홍대용:  기술 혁신과 중국 중심의 세계관 탈피를 주장한 실학자.
박지원: 수레와 선박, 화폐 이용으로 산공업 진흥을 주장한 실학자.
박제가: 소비의 자극을 통한 생산 확대와 청과 통상 확대를 주장한 실학자.

실학: 이 학문의 학자들 대부분이 정권에서 소외되어 결국 정책에 반영되기 힘들었다.; 양반 사회의 모순 비판과 노비 제도 개혁, 과거제 개선안, 새 인재 등용의 필요성을 강조한 학문.
개화 사상: 북학파의 실학사상이 영향을 준 사상

국학: 사회, 경제적 변동과 우리 문화에 대한 자부심과 현실에 대한 관심 확대로 발달한 학문.
안정복: "동사강목"을 저술하여 고조선~고려사를 독자적인 정통론을 세워 체계화한 사람.
동사강목: 고조선~고려의 역사를 독자적인 정통론을 세워 체계화한 서적.; 안정복이 저술한 서적.
유득공: "발해고"를 간행하여 발해사를 우리 역사로 체계화 할 것을 강조한 사람.
발해고: 발해사를 우리 역사로 체계화할 것을 강조하기 위해 간행된 서적.; 유득공이 간행한 서적.
이중환: "택리지"를 저술하여 각 지방의 자연환경과 인물, 풍속, 물산 등을 서술한 사람.
택리지: 각 지방의 자연환경과 인물, 풍속, 물산 등을 서술하고자 한 서적.; 이중환이 저술한 서적.
김정호: 산업과 문화에 대한 사회의 관심을 반영하고 이전 지도 제작 성과를 집약하여 대동여지도를 완성한 사람.
대동여지도: 김정호가 완성한 지도; 산맥, 포구, 하천, 도로망 등을 정밀하게 표시한 지도.
신경준: "훈민정음운해"를 저술한 사람.
유희: "언문지"를 저술한 사람.
이수광: "지봉유설"을 저술하여 외국 문물에 대한 정보를 수록한 사람.
지봉유설: 최초의 백과전서로 외국 문물에 대한 정보 등을 담고 있다.; 이수광이 중국을 오가면서 만든 최초의 백과전서.
이익: "성호사설"을 저술한 사람.
동국문헌비고: 영조 때 편찬되어 역대 문물제도를 정리하였다.

홍대용: 지구 자전을 논리적으로 설명한 사람.
김육: 시헌력을 도입하여 조선의 사정에 맞게 사용하게 한 사람.
곤여만국전도: 과학적이고 정확한 지도 제작에 도움을 주고 조선인의 세계관 확대에 영향을 준 세계 지도.
허준: "동의보감"을 편찬하여 전통 의학을 체계화한 사람.
동의보감: 허준이 집팔한 의학서; 전통 의학을 체계화하기 위해 집필된 서적.
이제마: 체질을 구분하여 치료하는 사상 의학을 확립한 사람.
농가집성-임원경제지; 임원경제지-농가집성: 조선 후기 농학의 발달을 보여주는 서적들. (2개)
정약용: 화성 축조에 사용된 거중기를 제작하여 비용과 노동력이 크게 절감하게 만든 사람.


서민 문화; 서민문화: 경제적으로 여유가 생긴 중인과 상민이 문화에 관심을 갖기 시작하면서 발달한 문화.; 서당 교육으로 글자를 읽고 쓸 줄 아는 사람이 늘면서 서민 의식이 성장하여 발달한 문화
한글 소설-사설시조; 한글 소설-사설 시조: 조선 후기 서민 문학에서 등장하여 유행한 것. (2개)
한글 소설: 평범한 인물이 주인공으로 등장, 사회의 모순과 비리를 비판하고 서민 감정을 그대로 표현한 서민 문학의 갈래; "홍길동전", "흥부전", "춘향전", "심청전" 등이 있다.
사설시조; 사설 시조: 일정한 형식에 얽매이지 않는 서민들의 삶과 감정을 쉽고 폭넓게 표현한 서민 문학의 갈래.

판소리: 서민들의 감정을 솔직하게 표현하고 원래 열두 마당이 있었으나, 현재 다섯 마당만 전해지고 있는 것.
탈춤: 춤과 노래와 사설이 뒤섞이고 해학과 풍자로 양반 사회를 비판하는 내용이 많은 것.
박지원: "양반전", "허생전", "호질"등을 저술하여 양반들의 위선과 무능을 비판한 사람.
시사: 중인들이 조직하여 문학 활동을 하고 시집을 간행하기도 한 단체.
정선: 진경 산수화를 개척한 사람; "금강전도", "인왕제색도" 등으로 유명한 사람.
진경 산수화: 정선이 개척한 우리나라 화풍.; 우리나라의 아름다운 산천을 사실적으로 표현한 화풍.
풍속화: 김홍도와 신윤복으로 유명한 것.
김홍도: 간결하고 소박한 필치로 서민들의 삶의 모습을 그린 사람.
신윤복: 양반들의 풍류와 부녀자의 생활 모습을 그린 사람.
민화: 나무, 꽃, 동물, 문자 등을 소재로 삼아 생활 공간을 장식하고 민중의 소원을 기원하는 그림이며 이것을 그린 이름이 알려지지 않은 작가들이 많았다.

김정희: 여러 대가의 필체를 두루 연구하고 자기 개성에 맞게 발전시켜 추사체를 확립시킨 사람.
청화 백자: 흰 바탕에 푸른 색깔로 그림을 그린 자기로 조선 후기에 유행했다.
보은 법주사 팔상전: 양반 및 부유한 상민층의 지원 아래 지어진 규모가 큰 건축물 (목조탑)
화성: 정조 때 축조된 수원에 있는 거대한 그것!


세도 정치: 왕실과 혼인 관계를 맺은 몇몇 가문이 정권을 장악하고 권력을 행사하는 정치 형태; 정조 사후 순조가 즉위하며 정치 세력간 균형이 붕괴되고 왕권이 약화되자 나타난 정치 형태.; 정조의 개혁 정책이 무산되고 개혁 세력이 위축되어 왕실과 혼인 관계를 맺은 몇몇 가문이 권력을 장악하여 행사하는 정치 형태.
세도 정치: 외척 가문인 안동 김씨, 풍양 조씨 등 몇몇 가문이 권력을 독점하는 형태의 정치 형태.; 순조, 헌종, 철종의 3대(약 60년)동안 계속된 정치 형태; 김조순이 순조의 장인이 되며 안동 김씨가 정치적 실권을 장악하고 나서부터 시작된 정치 형태.
관직: 세도가문이 벼슬자리를 재산 증식 수단으로 이용하며 매□매■이 성행하였다. □■?
과거제; 과거제도; 과거 제도; 과거: 이것에서는 실력보다 부정에 의해 합격이 결정되는 일이 많았다.
전정: 토지를 대상으로 거두는 세금.; 관리의 횡령 부분 보충을 위해 정해진 전세 이외 세금을 더 거두면서 문란.
군정: 군포를 거두는 세금.; 어린아이나 사망자에게 군포를 부과하며 문란.; 도망자의 군포를 이웃과 친척에게 부과하며 문란.
환곡: 봄에 곡식을 빌려 주었다가 약간의 이자를 붙여 가을에 갚게 하는 세금.; 삼정 중 가장 폐해가 심각한 것.; 강제로 떠넘겨 지거나 받지 않고도 이자를 내게하며 문란해진 것.
삼정: 전정, 군정, 환곡을 모두 모아서 부르는 말.; 조선 후기 여러 구실을 붙여 정해진 양 이상의 세금을 거두면서 문란해진 것.
암행어사: 삼정의 문란으로 백성의 고통이 커지자 정부는 이것을 파견하였지만 효과가 없었다.

예언 사상: "정감록", 미륵 신앙 유행, 무격신앙 번성 등으로 볼 수 있는 이 사상의 유행.
정감록: 이씨 왕조가 멸망하고 정씨 왕조가 수립된다고 예언한 것.
미륵 신앙: 미륵이 나타나 새로운 세상을 열고 구원한다는 신앙.
무격신앙; 무격 신앙: 무당이 굿이나 살풀이로 귀신을 달래어 화를 멀리하고 복을 비는 신앙.
천주교: 17세기 무렵 중국에 간 사신이 서양 학문의 하나로 소개하면서 일부 실학자들이 학문적으로 연구한 것; 18세기 후반 남인 계열 일부 학자가 신앙으로 수용, 이승훈이 청에서 세례를 받고 귀국하여 신앙활동을 이어나가 중인, 상민, 부녀자들 사이에서 확산된 것.; 조상에 대한 제사 거부가 발생하자 국왕의 권위에 도전한다고 하여 성리학적 질서 붕괴 행위로 규정, 탄압된 것.; 순조 즉위 이후 대대적으로 탄압된 것.; 평등 사상과 내세 신앙으로 인해 백성들의 큰 호응을 얻어 교세가 확대된 것.
최제우: 동학을 창시한 사람.
인내천: '사람이 곧 하늘'이라는 동학이 강조하는 평등사상.
동학: 유교, 불교, 도교를 바탕으로 민간 신앙의 요소를 융합한 교리를 가진 최제우가 창시한 것.; 인내천을 바탕으로, 보국안민, 후천 개벽 사상을 교리로 가진 것.;이것이 빠르게 몰락 양반과 농민들에게 빠르게 확산되자 혹세무민의 죄로 최제우를 처형하고 탄압한 것; 최제우 처형 이후 2대 교주 최시형은 "동경대전", "용담유사"를 펴내 교단을 재정비하고 전라도, 충청도 등지로 확산한 것.

홍경래의 난: 19 세기에 처음으로 일어난 대규모 항쟁; 중국 무역 통로로 상공업 발달, 광산촌에 임금 노동자가 증가할 때 정부가 평안도민을 차별 대우하고 가혹한 수탈을 해 불만이 늘어나 일어난 봉기; 청천강 이북의 대부분의 지역까지 장악하였으나 정주성 싸움에서 관군에 진압된 봉기.;
홍경래의 난: 한계점으로는 농민을 위한 개혁안이 제시되지 못했다는 점이 있다.; 탐관오리 착취와 서북 지방 차별 반대를 주장하며 일어난 봉기; 홍경래 등 몰락 양반과 신흥 상공업 세력이 주도하여 일어난 봉기
진주 농민 봉기: 탐관오리의 수탈에 저항하여 몰락 양반, 유계춘을 중심으로 봉기하여 관아 습격하고 조세 대장 소각하고 아전과 양반 지주의 집 습격한 봉기.; 이후 삼남 지방으로 확산되어 임술 농민 봉기가 된 봉기. 
임술 농민 봉기: 진주 농민 봉기 이후 삼남 지방으로 확산된 봉기; 대부분 고을 단위로만 봉기하여 한계가 있었다.; 이 봉기로 인해 농민들의 사회의식 성장에 기여하였다.


이양선: 우리나라 연해에 자주 출몰하여 해안을 측량하거나 통상을 요구하여 민심을 불안하게 한 서양 선박
흥선 대원군: 어린 고종을 대신하여 정권을 장악한 사람.;안동 김씨를 축출하고 인재를 고루 등용하려 했고, 비변사를 사실상 폐지시켰다.; '대전회통'을 편찬하여 통치 법령을 정비하였다.; 경제 개혁으로 양전을 실시하고 호포제를 실시하며, 사창제를 실시한 사람.; 통상 수교 거부 정책을 펼친 사람.; 임오군란 도중 다시 정권을 잡은 사람.
통상 수교 거부 정책: 이 정책은 서양 세력의 침략을 일시적으로 막는 데는 성공하였으나, 조선의 근대화가 늦어지는 결과를 초래하였다.
호포제: 양반에게도 군포를 징수하는 제도.; 서원을 대폭 정리하여 재정을 확보하고 농민 생활을 안정시켰다.
사창제: 환곡을 개혁하기 위한 제도로 각 마을에 어려운 백성에게 곡식을 빌려주는 사창을 만들고 덕망과 경제적 여유를 갖춘 사람에게 운영을 맡긴 제도이다.
경복궁: 흥선 대원군이 왕실의 위엄을 높이기 위해 중건하려던 건물.; 이것을 중건하는 과정에서 원납전을 징수하고 당백전을 발행하여 경제 혼란을 초래하였다.; 중건 도중 양반의 묘지림을 베고 공사에 백성을 동원하여 불만이 증가하였다.
당백전: 상평통보의 100배의 가치를 가졌으나 이것이 대량으로 발행되면서 인플레이션이 일어났다.
### 병인년(1866)
병인박해: 1866년, 양반 유생들의 천주교 금지 주장이 거세지자 흥선대원군이 프랑스 선교사와 수천 명의 신자를 처형한 사건.
제너럴 셔먼호 사건: 제너럴 셔먼호가 대동강에서 통상 요구하자 평안도 관찰사 박규수가 이를 거절했다. 이에 선원들이 관리를 살해하고 민가를 약탈하자 평양 관군과 주민들이 제너럴 셔먼호를 불태워 침몰시킨 사건.
병인양요: 병인박해를 빌미로 프랑스군이 강화도에 침입한 전쟁.; 문수산성에서 한성근 부대가 프랑스군을 막고, 정족산성에서 양헌수 부대가 프랑스군을 막아내 격퇴시킨 전쟁; 프랑스군이 퇴각하던 도중 외규장각의 도서와 보물을 약탈해간 전쟁.
###
오페르트 도굴 사건: 1868년 독일인 오페르트가 남연군묘를 도굴하려다 실패한 사건.; 남연군묘가 도굴당할 뻔한 이 사건이 정부에 알려지자 흥선 대원군은 서양에 대한 경계를 강화하였다.
### 신미년(1871)
신미양요: 제너럴 셔먼호 사건을 구실로 조선에 통상 조약 체결을 요구하기 위해 강화도를 침략한 전쟁; 미군이 초지진, 덕진진을 점령하고 광성보를 공격하려했으나 어재연이 이끄는 수비대가 광성보에서 미군에 맞서 항전하여 미군이 철수한 전쟁.
척화비: "서양 오랑캐가 침범함에 싸우지 않음은 곧 화의하는 것이요, 화의를 주장함은 나라를 파는 것이다."; 이것을 세워 통상 수교 거부 의지를 널리 알렸다.
###
통상 개국론: 부국강병을 위해 서양의 발달된 문물을 받아들이자는 주장.; 이 주장은 박규수, 오경석, 유홍기 등이 문호 개방의 필요성을 인식하며 주장하였다.; 흥선 대원군이 물러나고 고종이 집권하자 통상 수교 거부 정책이 완화되고 대두되었던 주장이다.
운요호: 일본이 조선에 통상을 강요하기 위해 보낸 군함.
강화도 조약: 운요호 사건을 빌미로 일본이 조선과 맺은 조약.; 조선이 외국과 맺은 최초의 근대적 조약이며 불평등 조약.; 이 조약에서 조선을 자주국이라고 밝히고 부산을 비롯한 3개 항구 개항, 치외 법권, 해안 측량권 등이 포함된 조약.; 조약 이후 부속 조약에서 일본 수출입 상품에 대한 무관세, 양곡의 무제한 유출 등이 허용되어 조선 침략 발판을 마련한 조약.
조미 수호 통상 조약: 일본의 세력 확대와 러시아의 남하로 청이 불안해지자 조선에 대한 종주권과 두 나라의 견제를 위해 조선과 미국의 교섭을 알선한 조약.;  이 조약에서 조선은 미국 상품에 관세를 부과할 수 있도록 하였지만, 치외 법권과 최혜국 대우를 인정한 조약.
최혜국 대우; 최혜국: 앞으로 어떤 나라와 조약을 체결할 때 그 나라에 부여한 가장 유리한 대우가 이미 조약을 체결한 다른 나라에도 자동으로 주어진다는 조항.
개화파: 1870년대 중반 박규수 등이 김옥균, 박영효, 서광범, 김홍집 등에게 개화사상을 전파하고 이런 이들이 개항 이후 중앙에 진출하여 성장한 정치 세력.
통리기무아문: 여러 개화 정책을 총괄하는 기구.
일본: 수신사, 조사 시찰단가 파견된 나라.
수신사-조사 시찰단; 조사 시찰단-수신사: 개혁에 필요한 정보를 얻기 위해 일본에 파견한 것. (2개)
청: 영선사가 파견된 나라.
영선사: 개혁에 필요한 정보를 얻기 위해 청에 파견한 것.
미국: 보빙사가 파견된 나라.
보빙사: 개혁에 필요한 정보를 얻기 위해 미국에 파견한 것.
위정척사 운동; 위정척사: 성리학을 지키고 서양의 문물과 사상을 물리치자는 의미의 운동.; 19세기 중엽 천주교가 유포되고 서양의 통상 요구가 거세지자 양반 유생층을 중심으로 성리학 질서를 지키고 외세의 침략을 물리쳐야 한다는 내용의 운동.; 1890년대 이후 항일 의병 운동으로 계승된 운동.; 19세기 중엽 서양과 일본의 경제적, 군사적 침략의 맞선 반외세, 반침략적 민족 운동.
통상 수교 반대 운동; 통상 반대 운동: 1960년대 위정척사 운동.
개항 반대 운동: 1970년대 위정척사 운동.
개화 반대 운동: 1980년대 위정척사 운동.
왜양일체론: 최익현이 주장한 왜는 서양 세력과 같다는 내용의 주장; 1970년대 위정척사 개항 반대 운동.
조선 책략; 조선책략: 1980년 대 이것이 유포되고 정부가 미국과 수교하려 하자 영남 유생들이 만인소를 올려 비판하였다.
별기군: 군사력 강화를 위해 창설한 신식 군대.
임오군란: 별기군보다 낮은 대우, 밀린 급료, 급료로 받은 쌀에 겨, 모래가 섞여있어 구식 군인들이 일으킨 폭동에 이에 개항 이후 오른 곡물 가격에 생활이 어려웠던 도시 하층민이 합세하여 정부 고관과 일본인 교관을 죽이고 일본 공사관을 습격한 사건.; 이 사건 도중 흥선 대원군이 재집권하여 개화 정책이 중단되었지만 청군이 개입하고 흥선 대원군을 납치하고 군란을 진압하며 민씨 세력이 재집권하였다.
임오군란: 이 사건 이후 청은 조선의 내정과 외교 문제에 깊이 관여하고 일본은 공사관 습격을 구실로 제물포 조약을 체결하였다.
제물포 조약: 임오군란 이후 배상금을 지불하고 일본 공사관의 경비병 주둔을 허용하는 조약.

온건 개화파: 김윤식, 김홍집, 어윤중이 중심이 되어 주도한 개화파.; 전통적 사회 질서를 유지하고 서양의 기술만 수용하는 점진 개혁을 추진하는 개화파.; 청의 양무운동을 모델로 하는 개화파.
급진 개화파: 김옥균, 박영효, 홍영식, 서광범이 중심이 되어 주도한 개화파.; 서양의 근대적 제도, 사상까지 받아들이는 급진 개혁을 추진하는 개화파.; 일본의 메이지 유신을 모델로 하는 개화파.
양무운동: 온건 개화파의 개화 모델.
메이지 유신: 급진 개화파의 개화 모델.

갑신정변: 임오군란 이후 청 간섭과 재정 부족으로 개화 정책이 소극적으로 추진되자 일본으로부터 차관 도입이 실패되자 위기에 몰린 급진 개화파가 우정총국 개국 축하 연회를 이용해 일으킨 정변.; 14개조 정강을 발표한 이후 청의 무력 개입으로 실패로 끝난 정변.
갑신정변: 이 정변의 결과로 청의 내정 간섭이 심화되고 한성 조약이 체결되었으며 청과 일본 사이에 톈진 조약이 체결되었다.; 근대적 건설을 목표로 한 최초의 정치 개혁 운동이지만 일본에 의존하고 백성의 지지를 얻지 못했다는 한계가 있음.
14개조 정강: 정변에 이어 청에 대한 사대 폐지, 문벌 폐지, 조세 제도 개혁 등을 주 내용으로 하는 이것을 발표하였다.
한성 조약: 갑신 정변 과정에서 일본 공사관이 불에 탄 것을 빌미로 이 조약을 체결하여 조선은 일본에게 배상금을 줘야했다.
톈진 조약: 청, 일 양국은 이후 조선에 군대를 보낼 때는 상대국에게 미리 알리기로 함을 내용으로 하는 조약.
거문도 사건: 러시아의 남하를 경계한 영국이 거문도를 불법 점령한 사건.
중립국;중립: 조선을 두고 열강의 대립이 치열해지자 조선을 이것으로 만들자는 주장이 제기되었다. (유길준과 부들러)

방곡령: 일본에서 막대한 양의 쌀을 수입해가 쌀값이 폭등하자 이것을 내려 곡물 유출을 막았다.; 일부 지방에서는 이것을 선포하여 곡물 유출을 막았지만 일본의 항의로 되려 배상금만 지불하게 되었다.
삼례: 공주, □□, 서울 등지에서 집회를 열어 교조 최제우의 누명을 벗겨 줄 것과 동학 박해 중지를 요구하였다. □□?
보은 집회: 동학에서 이 집회부터 탐관오리 처벌과 외세 배척 등 정치적 주장을 요구했다.
고부 농민 봉기; 고부 봉기: 조병갑의 비리와 학정으로 인해 농민들이 전봉준을 중심으로 일어나 관아를 습격한 사건.; 이 사건 이후 정부는 조병갑을 파면하였으나 책임을 농민에게 돌리고 주도자를 탄압하였다.
1차 동학 농민 운동; 동학 농민 운동: 고부 봉기에 대한 탄압에 전봉준 등이 '보국안민'과 '제폭구민'을 구호로 내걸고 농민들과 무장에서 봉기한 사건.; 동학 농민군이 황토현과 황룡촌 등지에서 잇따라 관군을 물리치고 전주서을 점령한 사건(봉기); 조선을 둘러싸고 청과 일본이 충돌할 것을 염려한 정부는 농민군의 요구를 받아들여 폐정 개혁을 조건으로 전주 화약을 체결한 봉기.;
집강소: 1차 동학 농민 운동에서 해산한 농민군은 전라도 각지에 일종의 농민 자치 조직인 이것을 설치하여 폐정 개혁안을 실천해 나갔다.
2차 동학 농민 운동; 동학 농민 운동: 일본군이 경복궁을 점령하고 청일전쟁을 일으키자 이에 동학 농민군은 일본을 몰아내기 위해 다시 봉기한 사건.; 이 봉기는 공주 우금치 전투에서 관군과 일본군에 패배하여 전봉준 등 지도부가 체포되고 처형당해 끝이 났다.
동학 농민 운동: 탐관오리 처벌 및 조세 제도 개혁을 주장하는 반봉건 민족 운동이자 일본의 침략을 물리치려 한 반외세 민족 운동이었다.; 이 봉기는 실패하였지만 농민군의 요구는 이후 갑오개혁에 일부분 반영되었다.

교정청: 전주 화약 이후 일본은 조선에 내정 개혁을 강요하자 조선은 이를 거부하고 이것을 설치하여 자주적인 개혁을 주장하였다.
김홍집: 조선이 교정청을 설치하자 일본은 경복궁을 점령하고 이 사람을 내세워 새 내각을 세웠다.
군국기무처: 김홍집 내각은 입법권을 가진 갑오개혁 당시 최고 정책 결정 기구였던 이것을 신설했다.
갑오개혁: 정치에서 궁내부를 설치하여 왕실 사무와 국정 사무를 분리하고 과거제를 폐지한 개혁; 경제에서 탁지아문을 설치하고 은 본위 화폐 제도를 채택한 개혁; 사회에서 신분제를 폐지하고 과부의 재가 허용과 조혼, 연좌제 폐지한 개혁.; 1차 이 개혁 이후 일본이 청, 일 전쟁에서 승기를 잡자 군국기무처를 폐지하고 박영효를 귀국시켜 개혁을 추진시킨 개혁; 2차 이 개혁때 고종은 홍범 14조를 반포하여 지방 행정 구역 개편과 사법권 독립이 이루어진다.
삼국 간섭: 러, 프, 독이 일본을 압박하여 청일 전쟁의 승리로 획득한 랴오둥(요동) 반도를 청에 반환시킨 사건.
을미사변: 삼국 간섭 이후 일본의 영향력이 약해지자 일본을 견제하기 위해 친러파 인사를 등용했다. 이를 만회하고자 일본이 명성 황후를 시해한 사건.
을미개혁: 을미사변 이후 다시 구성된 김홍집 내각이 추진한 개혁.; 태양력 사용, 단발령 실시 등을 추진한 개혁. ### 을미의병
아관파천: 을미사변 이후 신변의 위협을 느낀 고종이 러시아 공사관으로 처소를 옮긴 사건.; 이 사건으로 을미개혁은 중단되었다.
### 갑오, 을미는 일본에 간섭 속에서 추진되어 군제 개혁에 소홀했고 토지제 개혁 등도 이루어지지 않았다.
### 다만 갑신정변과 동학 농민 운동에서 제기되었던 요구를 일부 반영하였으며 근대적 제도를 수용.

독립 협회: 서재필이 개화파 지식인들과 함께 독립 협회 설립한 협회; 영은문을 헐고 독립문을 세워 자주독립 의지를 고취하고 독립 신문을 발행하여 독립 의식을 고취한 협회.; 토론회와 연설회를 개최하여 민중을 계몽하고 근대적 정치의식을 고취한 협회.; 만민 공동회를 개최하여 이권 수호 운동과 자유 민권 운동을 전개하였고, 관민 공동회까지 열어 헌의 6조를 채택하고 근대 의회 설립을 추진한 협회.; 보수파 관료들이 탄압하고 정부가 황국협회와 군대를 동원해 해산당했지만 이후 애국 계몽 운동으로 계승된 협회
만민 공동회: 이권 수호 운동과 자유 민권 운동을 전개하기 위해 연 최초의 근대적 민중 집회.
대한 제국; 대한제국: 아관파천 이후 러시아가 내정 간섭 심화되자 고종 환궁 요구가 증가하였다. 이에 고종이 경운궁(덕수궁)에 환궁해 국호를 이것으로 바꾸었다.
광무: 아관파천 이후 러시아가 내정 간섭 심화되자 고종 환궁 요구가 증가하였다. 이에 고종이 경운궁(덕수궁)에 환궁해 국호를 대한제국으로 바꾸고 연호를 이것으로 정했다.
구본신참: 광무개혁의 원칙.; 옛 제도를 근본으로 하고 새로운 제도를 참작한다는 의미.
대한국 국제: 정부는 이것을 반포하여 대한 제국이 자주독립 국가임을 밝히고 황제에게 군사권, 외교권, 사법권 등 모든 권한을 집중하였다.
광무개혁: 구본신참의 원칙에 따라 단행한 개혁; 군제를 개편하여 황제가 육, 해군을 통솔하도록 하고 중앙군의 군사 수를 늘리고, 지방 주요 도시에도 군대를 주둔시킨 개혁.; 양전을 실시하고 지계를 발급하고 상공업 진흥을 추진하여 근대적 회사가 설립되게 한 개혁.; 학교를 설립하고 유학생을 파견하여 인재 양성을 하게 한 개혁; 이 개혁은 지배층의 보수적 성향과 열강의 간섭, 러일 전쟁으로 지속적 성과를 거두는데 한계가 있었음.


















##!finish
### 세계사

구제도의 모순; 앙시앵 레짐; 앙시앵레짐: 제3 신분은 토지세, 인두세 등 여러 세금에 시달리면서 정치에는 참여하지 못하였고 상공업의 발달로 성장하게 된 시민 계급의 불만은 커졌다. 따라서 시민들은 이러한 모순을 비판하였다.
신분회; 삼부회: 전쟁과 궁정 생활로 재정이 어려워지자 루이 16세가 재정 문제를 해결하고자 전국적으로 소집한 것.
국민 의회: 신분회(삼부회)의 신분별 표결 방식으로는 자신들의 요규가 받아들여지기 어렵다고 생각한 제3 신분은 독자적으로 결성한 것.
테니스코트의 서약: 국민 의회가 결성된 후 새로운 헌법이 제정될 때까지 해산하지 않겠다고 선언한 것.
바스티유 감옥: 왕과 보수 귀족들이 국민 의회를 탄압하자 파리 시민들은 구제도의 상징이었던 이것을 습격하였다.
인권 선언; 인간과 시민의 권리 선언: 국민 의회는 봉건제 폐지를 선언하고 입헌 정치의 정신을 담은 이것을 발표하였다.
계몽 운동; 계몽 사상; 계몽: 이것은 인간이 갖고 있는 이성의 빛을 사용하여 무지와 미신을 타파하고 사회를 개혁하려고 하던 지식인들의 운동(사상)이다.
입법 의회: 입헌 군주제를 규정한 헌법이 제정되고 구성된 것.
국민 공회: 프랑스가 오스트리아에 전쟁을 선포하자 파리 민중들의 왕궁 습격으로 왕권이 정지되고 입법 의회가 해산되고 수립된 것.; 왕정 폐지 후 공화정을 선포하고 모든 남자 시민에게 투표권을 주고자한 입법 의회가 해산되고 수립된 것.; 로베스피에르가 주도한 것.
로베스피에르: 국민 공회를 주도하여 공포 정치를 실시한 사람.; 전쟁과 국내의 반란에 대응하기 위해 공안 위원회를 설치해 공화정에 반대하는 사람을 처형한 사람.; 시민들은 공포 정치에 불만을 느끼게 되었고, 결국 이사람은 처형되고 온건파가 주도권을 갖게 되었다.
총재 정부: 로베스피에르의 국민 공회 이후 5명의 총재가 이끌었지만 혼란이 계속되었던 것.; 나폴레옹이 쿠데타를 일으켜 무너뜨린 것.
나폴레옹: 오스트리아와의 전쟁에서 큰 공을 세운 뒤 쿠데타를 일으켜 총재 정부를 무너뜨리고 통령 정부를 세우고 제1 제정을 수립한 사람.; 반프랑스 동맹을 격파하고 국민 교육 제도의 도입과 중앙 집권적 행정 제도의 마련 등의 내정 개혁을 추진하여 지지를 얻은 사람.; 나폴레옹 법전을 편찬한 사람.; 영국을 제외한 유럽을 제패하여 프랑스 혁명 이념을 전파하여 자유주의와 민족주의 운동을 촉진시킨 사람; 대륙 봉쇄령을 내렸지만 러시아가 위반하여 러시아 원정을 시도하였지만 러시아의 초토화 작전과 혹한으로 참패하여 몰락한 사람.;=
메테르니히: 빈 체제를 주도한 오스트리아의 재상.
빈 체제: 나폴레옹 전쟁 이후 유럽의 전후 처리를 위해 메테르니히가 주도한 체제; 메테르니히가 주도한 복고주의 체제.; 이 것으로 인해 자유주의와 민족주의 운동이 탄압되었다.
자유주의: 개인의 존엄성과 표현성을 중시하는 사상.
7월 혁명: 빈 체제에 따라 들어선 부르봉 왕조가 자유주의 운동을 탄압하자 샤를 10세를 몰아내고 입헌 군주제 헌법을 마련한 것
2월 혁명: 7월 혁명 이후에도 재산에 따라 선거권을 차별하자 노동자와 시민들이 선거권 확대를 요구하며 공화정을 세운 것.; 이 것의 영향으로 메테르니히가 오스트리아에서 추방되고 빈 체제가 붕괴되었다.

공장법: 영국은 이 법을 제정하여 어린이와 부녀자의 노동 시간에 제한을 두었다.
### 계속 참정권 확대됨
인민헌장: 선거법 개정으로 시민 계층까지 참정권이 확대되었지만 노동자에는 선거권이 부여되지 않아 선거권을 요구하기 위해 노동자들이 발표한 것.
차티스트 운동: 노동자의 참정권을 위해 인민헌장을 발표하고 이를 관철시키기 위한 운동; 노동자의 참정권 요구 운동으로 영국 정부의 탄압으로 실패하였다.
곡물법-항해법; 항해법-곡물법: 영국은 이 법들을 폐지하여 자유주의 경제 체제를 확립하였다. (2개)

카보우르: 2월 혁명 이후 사르데냐의 재상으로 안으로는 산업을 육성하고 군대를 개편하고, 밖으로는 프랑스의 지원을 받은 사람.; 오스트리아와의 통일 전쟁에서 승리하여 이탈리아 중, 북부를 통일한 사람.
가리발디: 시칠리아, 나폴리를 점령하여 사르데냐의 왕에게 바쳐 이탈리아가 통일 되게 한 사람. ### -> 이탈리아 왕국
관세 동맹: 프로이센을 중심으로 결성된 경제적 통일을 의미하는 동맹.
비스마르크: 무력의 중요성을 강조한 철혈 정책을 내세워 오스트리아를 격파하고 프랑스도 격파하여 독일 통일을 한 사람.

라듐: 퀴리 부부가 발견한 것.
뢴트겐: X선을 발견한 사람.
다윈: 진화론을 주장한 사람.; "종의 기원"에서 적자생존의 진화론을 주장하며 생물학의 새로운 장을 연 사람.; 생존 경쟁, 자연 도태, 적자생존 등을 주장한 사람.
진화론: 다윈이 주장한 이론.; 이후 사회 진화론과 같은 사회사상에 영향을 준 이론.
사회 진화론: 다윈의 진화론이 열강의 제국주의의 이론적 토대가 되어 나타난 것.
멘델: 유전 법칙을 주장한 사람.
에디슨: 백열 전구의 특허를 얻은 사람.
낭만주의: 19세기 초반 계몽 사상에 대한 비판이 일어나며 이성 대신 감정과 상상력을 중시하는 이것이 유행하였다.
사실주의; 자연주의: 19세기 후반 현실을 있는 그대로 묘사하려는 이것이 나타났다.; 이것 이후 주관적인 인상을 강조한 인상파가 등장하였다.


보스턴 차 사건: 영국 정부가 동인도 회사의 차 판매 독점권을 인정해주고 차에 대해 세금을 부과하려하자 보스턴 항의 영국 동인도 회사의 배를 습격한 사건.; 이 사건은 미국 혁명의 신호탄으로 평가받고 있다.
대륙 회의: 보스턴 차 사건 이후 영국이 항구를 봉쇄하자 식민지 대표들은 이것을 열어 영국 의회를 부정하고 무역 중단하고 이후 민병대와 영국군이 충돌하며 독립 전쟁이 발발한다.
미국 독립 선언: 독립 전쟁 중 발표된 버지니아 권리 장전과 이것에는 인권에 대해 명시한다.[생략됨]
연방제: 독립을 달성한 13개 주는 1787년 필라델피아에서 이것을 특징으로 하는 헌법을 제정하였다.
삼권 분립: 미국 독립 이후 제정된 헌법에서 행정, 입법, 사법권을 나누는 이것에 대해 규정하였다.
민주 공화국; 민주공화국: 1787년 필라델피아에서 헌법을 제정하고 이후 1788년 세계 최초로 수립된 국가[형식(?)]
조지 워싱턴: 미국 초대 대통령이며 독립군 총사령관.
### 자유를 추구한 독립 혁명이며, 민주주의 이념을 실현한 시민 혁명이었다.
### 프랑스 혁명과 라틴 아메리카 독립 혁명에 커다란 영향을 주었다.
크리오요: 신대륙 발견 이후 라틴 아메리카로 이주한 에스파냐인의 후손.; 라틴 아메리카의 독립에 주도적인 역할을 하였다.
볼리바르: 군대를 이끌고 에스파냐에 맞서 라틴 아메리카의 독립을 위해 싸워 베네수엘라, 콜롬비아, 볼리비아 등이 연이어 독립을 이루게 한 사람.
이달고 신부; 이달고: 봉기를 일으켜 에스파냐로부터 독립하는데 도움을 준 사람.
먼로주의: 1823년 먼로 대통령이 발표한 아메리카 대륙에 대한 유럽의 간섭이나 식민지 건설을 허용하지 않곘다는 미국 외교의 기본 정책.

서부 개척: 독립 이후 미국은 적극적인 이것을 통해 대서양과 태평양 연안까지 영토를 확장하고 철도와 운하의 건설이 많았다.
공업: 미국 동북부에서는 철, 석탄과 같은 자원을 활용해 이것이 발달하였다.
노예: 남부에서는 넓은 토지에서 이것을 이용해 목화를 생산하는 대농장이 발달하였다.
연방주의; 공화당: 미국 북부에서 강세인 정치 형태.
분리주의; 민주당: 미국 남부에서 강세인 정치 형태.
보호 무역: 미국 북부에서 강세인 무역 형태.
자유 무역: 미국 남부에서 강세인 무역 형태.
노예제; 노예제 문제; 노예 제도 문제; 노예 제도; 노예제도; 노예제도 문제: 미국 북부와 남부에서의 사회, 경제적 차이에서 생긴 북부와 남부 사이의 갈등은 이 문제로 더욱 심화되었다.
남북 전쟁: 북부 출신의 링컨이 대통령에 당선되자 남부의 여러 주는 연방 탈퇴를 선언하며 따로 헌법을 제정하고 남부 연합을 결성하여 발발한 전쟁.; 이 전쟁 초기에는 남부가 우세하였지만 북부가 노예 해방 선언으로 여론의 지지까지 얻어 점차 승기를 잡았다. 결국 4년간의 전쟁은 북부의 승리로 끝나고 노예제는 폐지되었다.

알렉산드르 2세: 농노 해방, 지방 의회 구성, 군사 제도 개혁 등의 내정 개혁을 실시한 러시아 사람이며 급진주의자들에게 암살당한 후 전제 정치가 강화된다.
브나로드 운동: 알렉산드르 2세의 내정 개혁의 혜택이 농민에게 돌아오지 않자 농민 계몽에 힘쓰기 위해 지식인들이 전개한 운동.
나로드니키: 브나로드 운동을 추진한 지식인.
시베리아 횡단 철도: 19세기 말 러시아 정부의 적극적인 지원으로 건설되어 석탄, 철광, 방직, 공업 등이 발달할 수 있는 계기가 된 철도.
크림 전쟁: 러시아가 부동항을 얻기 위해 오스만 제국과 치르던 전쟁, 영프의 개입으로 국제전의 성격을 띔.


제국주의: 제한된 시장 규모로 인해 불황이 나타나자 자본주의 열강들이 원료 공급지와 상품 판매 시장을 확대하고자 경쟁적으로 아시아, 아프리카를 식민지로 삼고 자본의 투자처로 만드려하는 팽창 정책.; 이것을 정당화하기 위해 사회 진화론이 사상적 기반이 되었다. (+백인우월주의)
3C 정책; 3C: 영국의 카이로, 케이프타운, 콜카타
3B 정책; 3B: 독일의 베를린, 비잔티움(이스탄불), 바그다드; 독일은 이 정책으로 발칸 지역, 서아시아, 아프리카로 세를 확장하려 했으나 영국과 러시아를 자극했다.
횡단 정책: 프랑스는 알제리를 거점으로 사하라 사막에서 마다가스카르에 이르는 이것을 추진하여 영국과 경쟁하였다.
종단 정책: 영국이 아프리카를 북에서 남으로 점령하는 정책.
케이프타운-카이로; 카이로-케이프타운: 영국의 종단 정책 도시. (2개)
마다가스카르-알제리; 알제리-마다가스카르: 프랑스의 횡단 정책 도시. (2개)
세실 로즈: 영국의 대표적인 제국주의자.

동인도 회사: 영국은 이것을 통해 인도를 지배하다가 19세기 후반 영국 여왕이 파견한 총독이 인도를 직접 통치하게 되었다.

베를린 회의: 벨기에의 콩고 사유지 선언에 반발하여 열린 회의이며 '먼저 점령하여 지배권을 획득한 나라'에게 선점권을 주며 아프리카 분할이 본격화 됨.
라이베리아-에티오피아; 에티오피아-라이베리아: 아프리카는 이 나라들을 제외한 전 나라가 열강의 식민지가 되었다 (2개)
파쇼다 사건: 영국의 종단 정책과 프랑스의 횡단 정책이 충돌하여 일어난 사건.
