/##/
Before you Start:
you must input two element with '-' and not spacing.
and enjoy history exciting
/##/
### 조선 초기 왕들 ### 유교는 무조건 성리학
급진파 사대부; 급진파 신진 사대부; 급진파 신진사대부: 조선의 건국 세력 중 정도전이 속하는 세력.
신흥 무인 세력; 신흥무인세력: 조선의 건국 세력 중 이성계가 속하는 세력. 
조선: 태조가 고조선을 계승한다는 뜻에서 지은 나라 이름.; 고려 말 신흥 무인 세력과 급진파 사대부가 위화도 회군을 계기로 권력을 장악하고 연 나라.
과전법: 관료에게 경기 일대 토지의 수조권을 지급한 제도.; 권문세족이 차지하고 있는 토지를 거두어 경기 일대의 수조권을 재분배한 제도.; 이 제도로 인해 신진 사대부의 경제 기반이 강화되었고, 권문 세족의 경제 기반은 약화되었다.
한양: 조선의 수도.
한양: 한반도의 중앙에 위치하기 때문에 천도한 지역.; 한강이 흘러 육로와 수로 교통이 편리해 천도한 지역.; 주변이 산으로 둘러싸여 있어 외적을 막기에 유리하여 천도한 지역.
성리학: 조선의 국가 통치의 근본 원리
태조; 태조 이성계; 이성계: 조선 건국 왕.
정도전: 조선 초기 나라의 기틀을 마련하는 일에 앞장선 대표적인 급진파 사대부.; 성리학을 중심으로 나라를 운영하고, 현명한 재상이 정치를 이끌어야 한다고 주장한 사대부.
왕자의 난: 두 차례에 걸쳐 일어났으며, 정도전을 비롯한 태종의 반대파를 제거하게 한 사건.
이방원, 태종: 왕자의 난을 일으킨 사람.; 호패법을 실시하여 인구를 파악하고 세금과 군역을 확보한 왕.; 공신과 왕자들의 사병을 없애 왕권을 강화한 왕.
호패: 신분을 증명하기 위한 것이며 16세 이상의 모든 남자가 지니고 다녔으며, 신분에 따라 재료, 내용이 달랐다.
사병: 태종이 혁파하여 왕권을 강화한 것.
세종; 세종대왕; 세종 대왕: 태종 때 이루어진 안정된 왕권을 바탕으로 유교(성리학) 이상에 맞는 정치를 실현하고자 한 왕.; 집현전을 설치한 왕.; 훈민정음 왕.; 전세 제도를 정비하였으며 유교에 이상에 맞는 정치를 실현하고자 하였다.
세조: 단종을 몰아내어 왕위에 오른 왕.; 직전법을 실시하였으며, 군사 제도를 정비하여 국방을 강화한 왕.
직전법: 현직 관리에게만 수조권을 주는 제도.; 과전법 실시 이후 각종 명목으로 세습되는 토지가 많아 재정을 확보하기 위해 실시한 제도.
성종: 홍문관을 설치한 왕.; 세조 때 중단되었던 경연을 다시 연 왕.; 경국대전을 완성하여 유교(성리학) 중심의 국가 통치 질서를 확립한 왕.
홍문관: 집현전을 계승한 기구, 성종이 설치함.
사대 관계; 사대: 명과의 불필요한 충돌을 피하고 실리를 추구하고자 태종 이후 조선이 명과 맺은 관계.
교린 정책; 교린: 조선이 여진과 일본에 대하는 정책; 일본, 여진에 대하여 회유와 토벌을 함께하는 정책.
4군: 세종 때, 여진이 침범하자 최윤덕을 파견하여 압록강 지역에 설치한 것.
6진: 세종 때, 여진이 침범하자 김종서를 보내 두만강 부근에 설치한 것.
쓰시마 섬: 왜구를 소탕하기 위해 토벌한 곳.; 조선이 일본에 대해 강경책으로 토벌한 곳.
### 조선에 협력하거나 귀순한 사람에게는 관직과 토지
### 일본은 제포, 부산포, 염포를 열어 제한적 교류.
### 류큐, 동남아시아: 친선 관계이며, 이들은 사신을 파견하여 토산품을 바침.

의정부: 조선 시대 재상들이 모여 정책을 의논하는 기구.
6조: 조선 시대 정책을 집행하는 기구.
### 이조, 호조, 예조, 병조, 형조, 공조
3사: 조선 시대 언론 기관.; 권력의 독점과 부정을 막기위한 기관.
사헌부: 3사의 관리의 비행을 감시하는 기구.
사간원: 원이 올바른 정치를 하도록 간쟁하는 기구.
홍문관: 왕의 정책에 대한 자문과 경연을 담당하는 기구.
경연: 신하가 왕에게 역사와 유교 경전을 강의하는 것.; 이를 통해 왕과 신하들은 학문과 정책에 대하여 의견을 나눔.
승정원: 국왕의 명령을 발표하고 상소문을 처리하는 기구.; 왕의 비서 역할을 하는 기구.
의금부: 나라의 큰 죄인을 다스리는 기구.
춘추관: 역사 편찬을 담당하는 기구.
한성부: 한양의 행정과 치안을 담당하는 기구.
성균관: 유학 교육을 담당하는 기구.
승정원-의금부; 의금부-승정원: 왕권을 보좌하여 왕권 강화를 뒷받침한 정치 기구. (2개)
8: 조선은 전국을 x도로 나누었다. x는 몇?
부-목-군-현; 부목군현: 조선은 전국을 8도로 나누고 그 아래 이것을 두었다.
수령: 모든 군현에 이것을 파견하여 중앙 집권을 강화하였다.; 향리는 이것의 실무를 보좌하는 세습적인 아전으로 지위가 낮아짐.; 고려 시대보다 품계와 권한이 강화되어 지방의 행정, 사법, 군사 업무를 모두 담당하게 되었다.
관찰사: 수령을 지휘, 감동하기 위해 각 도에 파견한 것.
유향소: 각 지역의 양반들이 자발적으로 운영하여 수령의 자문에 응하고 향리의 비리를 감시하며 백성을 교화하였다.
76: "조선은 x세에서 y세의 모든 양인 남자는 군대에 가거나, 국방의 비용을 부담하였으나 관료, 학생, 향리 등은 군역을 면제 받았다."에서 x+y는?
44: "조선은 x세에서 y세의 모든 양인 남자는 군대에 가거나, 국방의 비용을 부담하였으나 관료, 학생, 향리 등은 군역을 면제 받았다."에서 y-x는?
학생-향리; 향리-학생: 관료외의 군역을 면제받는 대상은? (2개)
5위: 조선의 중앙군.
병마절도사: 지방의 각 도에 파견되어 육군을 통솔하였다.
수군절도사: 지방의 각 도에 파견되어 수군을 통솔하였다.
잡색군: 평시에는 생업에 종사하다가 유사시에 병력으로 동원되는 예비군.
조운제; 조운; 조운 제도; 조운제도: 지방의 세곡을 강과 바닷길을 통해 서울의 경창으로 운송하는 제도.
봉수제; 봉수 제도; 봉수제도: 국경지역의 위급사항을 전달하는 제도.
역원제; 역원 제도; 역원제도: 말과 숙박을 제공하는 제도.
역: 말을 갖춘 곳.
원: 숙박 시설.
진: 선박을 갖춘 곳.
4부 학당; 4부학당: 지방의 항교와 비슷한 역할, 서울에 위치했다.
향교: 서울의 4부 학당과 비슷한 역할, 지방에 위치했다.
성균관: 향교, 4부 학당 출신과 소과 합격자는 이곳에 입학하였다.
### 과거(문관(생진과[소과](생원과, 진사과), 문과[대과]), 무관(무과), 기술관(잡과(역과, 율과, 의과, 음양과)))
음서-천거; 천거-음서: 실력을 중시하는 사회 기풍이 확대됨에 따라 이 제도들의 혜택을 받는 대상이 크게 줄었다. (제도는 빼고 입력)
실용적-자주적; 자주적-실용적: 조선 전기에는 백성의 생활을 편안하게 하고 나라를 부강하는데 힘써 이러한 문화가 발달. (~적, 2가지)
훈민정음: 민족 문화가 발달할 수 있게 된 토대.; 이것으로 백성들도 편리한 문자 사용이 가능하게 됨.; 세종이 집현전 학자들과 창제하였고 반포함.; 이것은 하급 관리 시험에 적용되었다.
훈민정음: 이것은 독창적이고 과학적인 문자이고 누구나 쉽게 배울 수 있어 백성도 자신의 생각을 글로 표현 가능하게 됨.; "용비어천가", "월인천강지곡"는 이것으로 편찬되었다.
용비어천가: 태조의 4대 조상과 역대 왕들의 공적을 기리는 내용.; 훈민정음으로 쓰인 최초의 작품.
국조오례의: 국가의 행사에 필요한 의례를 정리한 서적.
삼강행실도: 효자, 충신, 열녀의 이야기를 한문으로 쓰고 그림을 그렸으며, 훈민정음으로 설명을 단 서적.; 백성들에게 유교 윤리를 쉽게 설명하기 위해 그림까지 첨부한 서적. -> 성리학적 질서 확립.
고려사-고려사절요; 고려사절요-고려사: 고려의 역사를 정리하여 만든 서적. (2가지)
조선왕조실록: 국가의 통치 기록을 모아 태조~철종 때까지의 역사 기록을 편찬한 서적.
혼일강리역대국도지도: 태종 때 세계 지도.
팔도지리지-동국여지승람; 동국여지승람-팔도지리지: 각 지역에 대한 정보를 담고 있는 지리서. (2가지)
천상분야열차지도: 태조 때 고구려 고분의 별자리를 바탕으로 제작된 천문도.
간의-혼천의; 혼천의-간의: 세종 때 제작된 천체의 운행을 관찰하고 위치를 측정하는 것. (2가지)
앙부일구: 해의 그림자를 이용해 시간 측정하는 것.
자격루: 물의 흐름에 따라 스스로 소리를 내어 시각을 알리는 장치.
칠정산: 중국과 아라비아 역법을 참고하여 만든 역법서.;한양을 기준으로 날짜와 계절의 변화를 계산하는 기술을 설명하는 역법서.
측우기: 세계 최초 강우량 측정기.; 농사 중시의 조선은 이 것을 제작하여 가뭄과 홍수에 대비함.
인지의: 토지의 높낮이 등을 측정하는 것.
농사직설: 중국의 농업을 우리 실정에 맞게 정리한 농서.
향약집성방: 쉽게 구할 수 있는 약재의 사용법 제시.
의방유취: 조선 전기 의학의 집대성.
계미자: 태종 때 금속 활자.
갑인자: 세종 때 금속 활자.
화통도감: 이 것을 설치하여 신기전을 비롯한 화포, 화차 등의 화약 무기를 개발하였다. -> 여진과 왜구 토벌에 활용.
분청사기; 백자: 조선 전기에는 소박하고 강직한 마음가짐을 중요시하여 깨끗하고 소박한 느낌의 이것을 사용하였다. (하나만)
고사관수도: 강희안이 선비들의 정신 세계를 그린 것.
몽유도원도: 안견이 그린 현실 세계와 이상 세계를 표현.
사군자화; 사군자: 16세기에는 강직한 선비 정신을 상징하는 매난국죽을 소재로한 이것이 유행.
아악: 세종 때 궁중 음악인 이것을 정리함.
종묘 제례악: 종묘에서 제사를 지내는 동안 연주되는 음악.
악학궤범: 성종 때 음악적 성과를 모아 이것을 간행함. 

훈구; 훈구 세력: 세조 즉위에 공을 세워 고위 관직을 차지하고 정치를 장악한 세력.; 대를 이어 권력을 독점하고 많은 토지와 노비를 소유한 세조 즉위에 공을 세운 세력.
사림; 사림 세력: 조선 건국에 협력하지 않고 낙향한 온건파 사대부의 제자 세력.; 대부분 지방의 중소 지주 출신이며, 도덕과 의리를 바탕으로 하는 왕도 정치를 추구한 세력.; 주로 언론 기관인 3사에 진출하여 훈구의 잘못을 비판한 세력.; 선조 때에 이르러 훈구 세력을 몰아내고 중앙 권력을 차지한 세력.
김종직: 성종이 훈구 세력을 견제하기 위해 이 사람을 비롯한 경상도 지역의 사림을 등용함.
사화: 사림이 훈구 세력과 외척 세력으로부터 받은 정치적인 탄압.
무오사화: 연산군 때, 김종직의 '조의제문'을 문제 삼아 일으킨 사화.
갑자사화: 연산군이 친어머니가 폐위된 것을 이유로 사림은 물론 훈구까지 몰아내면서 발생한 사화.
중종반정: 연산군의 폭정에 반발하여 훈구가 연산군을 내쫗고 중종을 왕으로 세운 사건.
조광조: 훈구 세력이 정치를 장악하자 중종이 견제하기 위해 등용한 사람.; 왕도 정치의 실현을 내세우며 소격서 폐지, 현량과 실시, 훈구 대신의 공훈 삭제 등의 개혁을 추진한 사람.
기묘사화: 조광조의 개혁에 반발한 훈구가 조광조를 비롯한 많은 사림을 제거하며 일어난 사화.
을사사화: 외척 세력 간에 권력 다툼으로 벌어진 사화.
서원-향약; 향약-서원: 사림의 세력 확대 기반. (2가지)
이조 전랑: 외척 처리 문제를 두고 기성 사림과 신진 사림 간의 의견 충돌이 심했는데 이때 이것의 임명 문제로 더욱 심화되었다.; 3사의 관리를 뽑을 수 있고 자기 후임자를 추천할 수 있는 자리.
붕당: 신진 사림을 중심으로 한 동인과 기성 사림을 중심으로 한 서인으로 나누어져 형성된 것.
동인: 주로 이황과 조식의 가르침을 받은 사림이 많은 당.
서인: 주로 이이와 성혼의 학문을 따르는 사림이 많은 당.
### 둘다 모두 왕도 정치를 실현하고자 하였지만 방법에 따라 다를 뿐이었다.
### 따라서 서로 입장을 인정하며, 비판 견제를 통해 정치를 이끌었다.
백운동 서원; 소수 서원: 중종 때 주세붕이 세운 최초의 서원.;이황의 건의로 사액 서원이 된 서원.
서원: 덕망 높은 유학자에게 제사를 지내고, 성리학을 연구하며 지방 양반의 자제를 교육한 곳.; 지방 사림의 여론을 형성하는 역할을 했으며 향촌에 성리학을 보급해 지방 문화 발달에 기여한 곳.
사액 서원: 국가가 현판을 하사하여 토지, 노비, 서저을 지급하고 세금을 면제하는 서원.
향약: 향촌 자치 규약이며 전통적 공동체 조직에 유교 윤리가 결합한 것.; 조광조가 "여씨 향약"을 변역하며 4대 덕목을 알리고, 이황, 이이 등 사림의 노력으로 확산된 것.; 지방 농민을 성리학 윤리로 교화하였으며 사림의 향촌 지배력 확대에 기여한 것.
소학: 사림이 성리학 질서를 위해 보급한 책 중 삼강오륜의 실천을 위한 기본서.
주자가례: 사림이 성리학 질서를 위해 보급한 책 중 관혼상제의 예법을 정리한 서적.
명분론: 성리학에서 지위에 맞는 역할을 수행해야한다는 론.; 이것으로 남녀, 적서 간의 차별을 인정하고 각자의 역할에 충실할 것을 강조하여 신분제도가 강화되었다.
이황: 성리학을 이상주의적인 관점, 훌륭한 군주의 모습을 제시한 학자. "성학십도"를 저술했다.
이이: 현실적, 개혁적 성격이 강했으며 신하의 역할을 중시한 학자이다. "성학집요"를 저술했다.

임진왜란: 전국 시대를 통일한 도요토미 히데요시가 내부 불만 세력의 관심을 밖으로 돌리고 대륙으로 진출하고자 조선에게 명을 정벌하러 가는 길을 빌려 달라는 구실로 조선을 침략한 전쟁.
수군: 이순신이 이끔.; 옥포, 당항포, 부산, 한산도 등지에서 왜군을 격파한 조선의 군대.; 이 군대의 활약으로 곡창 지대는 수호되었고, 왜군의 무기, 식량 보급이 저지되었다.
이순신: 임진왜란 당시 조선의 수군을 이끈 장수.
의병: 사림, 전직 관리 등이 지역 농민을 모아 결성한 것.; 향토 지리에 알맞는 전술 구사로 왜군에게 큰 타격을 준 것.
정유재란: 전세가 불리해진 왜군은 휴전을 제안하지만, 무리한 요구로 인해 결렬되었고 이에 따라 일본이 다시 조선을 침략하는 전쟁.
통신사: 일본의 요청으로 조선이 파견한 대규모 사절단.

광해군: 북인의 지지에 의해 왕위에 올랐으며 임진왜란 이후 복구에 노력한 왕.; 허준에게 동의보감을 간행하도록 한 왕.; 국가 재정을 회복하기 위해 토지 대장을 정리하고 호적을 새로 정비한 왕.; 후금과 명 사이에서 중립 외교를 펼친 왕.; 명이 조선에게 지원군을 요청하자 강홍립을 파견해 상황에 따라 대처할 것을 지시한 왕.; 후금과의 충돌을 피해 실리를 추구하였지만 서인들의 비난을 받음.
강홍립: 광해군에 의해 명에 파견되어 상황에 따라 대처한 사람.
인조반정: 광해군의 중립 외교에 대한 일부 사림의 비판이 고조되고 반인륜행위(인목 대비 폐위, 영창 대군 살해)에 대한 서인들의 반발로 광해군 축출되고 인조를 추대한 사건.
친명배금; 친명배금 정책: 명과 가까이 하고 후금을 배척하는 정책.; 인조반정으로 정권을 잡은 인조와 서인 정권의 외교 정책. 
이괄의 난: 인조반정 후 공신 선정에 대한 불만으로 이괄이 일으킨 반란.
정묘호란: 친명배금에 반발한 후금이 이괄의 난으로 혼란해진 조선을 침략한 전쟁.; 관군, 백성, 의병들이 후금의 진격을 막았고, 후금은 명 공격을 준비하기 위해 화친을 맺고 퇴각한 전쟁.
병자호란: 후금이 국호를 '청'으로 변경하고 조선에 군신 관계를 요구했으나 거절해서 발생한 전쟁.; 척화파(윤집)에 따라 남한산성에서 항전을 유지했으나, 결국 주화파(최명길)에 따라 항복하여 삼전도에서 굴욕적인 강화를 체결한 전쟁.
북벌 운동: 청에 패한 것에 대한 충격이 커서 청 정벌을 통해 치욕을 씻을 것을 주장한 것.; 효종, 송시열 등이 군대를 양성하고 성곽과 무기 정비 등으로 준비한 것.; 청이 너무 강성하고 백성들의 원망이 심했고 효종이 죽자 끝난 것.
북학 운동: 현실을 인정하고 청의 발달된 문물을 수용하자는 움직임.
나선 정벌: 청이 러시아와의 대립에서 지원군을 요청하자 효종이 조총 부대를 두 차례 파견하여 승리를 거둔 것.







### 세계사
/##/
르네상스; 이탈리아 르네상스: 14~16세기 유럽에서 그리스, 로마 문화의 가치를 재발견하려는 인간 중심 문예 부흥 운동; 인문주의 
알프스 이북의 르네상스; 알프스 이북 르네상스: 16세기 이후 전파되며 교회의 부패 비판과 현실 풍자

/##/